30
15
WWWWWWWWWWWWWWWWWWWWWWWWWWWWWW
WA  W   W  WW      W WWW WW WW
WWW W    WW   W      W  W   WW
W     W   W   WW W  WWW   WWWW
W  W W  WW W  W  WW          W
W W  WW  W  W W W  W  S   WW W
WW      WW   W W   W W    WW W
WB  W W WWWWWW W       W  W WW
W     W WW       WW W        W
WW   WW WWW     W W  WWW     W
WW    W      W W    WWW  WW  W
W   W  W W  W    WW      W   W
W     W  W     W W      W   WW
W     W    W   WW    WWWWW  IW
WWWWWWWWWWWWWWWWWWWWWWWWWWWWWW
1 7     Ben 
1 1      P1
28 13    P2
22 5     Switch 