30
15
WWWWWWWWWWWWWWWWWWWWWWWWWWWWWW
WA      WW   WW  W WWWW W W WW
W  WW   WWW   WW  WW    W  W W
W WW    WW  W  W  W    WW W  W
W    WWW WW         W        W
WW        W      W   WS     WW
W   W W W    W   W       W   W
WBW  W W    W WWW  WWW WWW   W
W  W W        WW  W W WW WW  W
W W   W W   W    WW    WW   WW
W  WW W    WW   W W   W   WW W
WW W     W W             WWWWW
W     W   WW     W  W W WW   W
WW WW      W W    W  W      IW
WWWWWWWWWWWWWWWWWWWWWWWWWWWWWW
1 7     Ben 
1 1      P1
28 13    P2
22 5     Switch 