30
15
WWWWWWWWWWWWWWWWWWWWWWWWWWWWWW
WA W                   W     W
W  W  WWWW    WW   WW  W  WW W
W     W  W WWW W       WS W  W
W  WWWW      W  WWWW         W
W     W   WWWW        WWWWW  W
W     W   W     WWWWWWW   W  W
W     W   W  W  W         W  W
W         W  W  W     W    W W
W  W    WWW     W    WWW     W
W  W        WWWWWW    W    WWW
W  W  BWWWW       W       W  W
W WWW       W    W     WW    W
W           W       W       IW
WWWWWWWWWWWWWWWWWWWWWWWWWWWWWW
6 11     Ben 
1 1      P1
28 13    P2
24 3     Switch 