30
15
WWWWWWWWWWWWWWWWWWWWWWWWWWWWWW
WA          W       W        W
W   W           W            W
W W     WWWWWWWWWW WWWWWWWWW W
W    W        W         W    W
W                 W  WS      W
WWWWWWWWWWWWWW       WWWW WWWW
WB           W               W
W     WWW    WWWWW WW  W     W
W       W              W     W
W     W  W   W    W   W   W  W
W     W      WW     WW       W
W  W  WWWWW        W    W W  W
W            W     W        IW
WWWWWWWWWWWWWWWWWWWWWWWWWWWWWW
1 7     Ben 
1 1      P1
28 13    P2
22 5     Switch 